11111111111111111111111111111
11111111111111111111111111111
11111111111111111111111111111
11111111111111111111111111111
11111111111111111111111111111
11111111111111111111111111111
11111111111111111111111111111
11111111110000C00001111111111
11111111110000C00E01111111111
11111111110000C00001111111111
11111111110000000001111111111
11111111110000000001111111111
11111111110000000001111111111
11111111110000000001111111111
11111111110000000001111111111
11111111110000000001111111111
11111111110000000001111111111
11111111110000000001111111111
11111111110000000001111111111
11111111110000000001111111111
11111111110000000001111111111
11111111110000000001111111111
11100000000000000000000000111
11100000000000000000000000111
11100000000000000000000000111
11100000000000000000000000111
11100000000000000000000000111
1110000P000000000000000000111
11100000001111111110000000111
11100000001111111110000000111
11111111111111111111111111111