1111111111111111111111111111
1111111111111111111111111111
1111111111111111111111111111
1111111111111111111111111111
1111111111111111111111111111
1111100000000000000000011111
111110P000000011111100011111
1111100000000110111110011111
1111100C00000111111110011111
11111000V0000111100000011111
1111100000000111111000011111
1111100100001111000000011111
1111100110011111110000011111
1111100111111111010000011111
1111100111111111000000011111
11111000111111110000E0011111
1111100001111110000000011111
1111100000111100000000011111
11111000001101000000V0011111
1111100000100100000000011111
1111100000110110000000011111
1111100000000000000000011111
1111111111111111111111111111
1111111111111111111111111111
1111111111111111111111111111
1111111111111111111111111111
1111111111111111111111111111