1111111111111111111111111111
1111111111111111111111111111
1111111111111111111111111111
1111111111111111111111111111
1111111111111111111111111111
111110000000000000C000011111
111110P000000011111100011111
1111100000000110111110011111
1111100C00000111111110011111
11111000V0000111100000011111
1111100000000111111000011111
11111001000011110000V0011111
1111100110011111110000011111
111110V111111111010000011111
1111100111111111000000011111
11111000111111110000E0011111
1111100001111110000000011111
1111100000111100000000011111
1111100C001101000000V0011111
1111100000100100000000011111
111110000011011000C000011111
1111100000000V00000000011111
1111111111111111111111111111
1111111111111111111111111111
1111111111111111111111111111
1111111111111111111111111111
1111111111111111111111111111