1111111111111111111111111111111111111111
1111111111111111111111111111111111111111
1111111111111110000001111000000100000001
1111111111111100000001111000001100000001
1111111111111000000011111000011100000001
1111111111110000000111111000111100000001
1111111111100000001111111001111100000001
1111111111000000011111111001111100000001
1111111110000000111111111011111100000001
1111111100000001111111111111111000000011
1111111000000011111111111111110000000111
1111110000000111111111111111100000001111
11111000V0001111111111111111000000011111
1111000000011111111111111110000000111111
1110000000111111111111111100000001111111
1100000001111111111111111000000011111111
1000000000000000000000111000000011111111
1000000000000000000000111000000011111001
1000000000000000000000111000000011110001
10000000P0000000000E00111000000011100001
1000000000000000000000111000000011000001
1100000000000000000000111000000010000001
1111111111111110000000111000000000000001
1111111111111110000000111111111111111111
1111111111111110000000111111111111111111
111111111111111000C000111111111111111111
1111111111111110000000111111111111111111
1111111111111110000000111111111111111111
1111111111111111111111111111111111111111
1111111111111111111111111111111111111111