1111111111111111111111111111111111111111
1111111111111111111111111111111111111111
1111111111111111111111111111111111111111
1111111111111111111001111111111111111111
1111111111111111111001111111111111111111
1111111111111111110000111111111111111111
1111111111111111110000111111111111111111
1111111111111111110000111111111111111111
1111111111111111110000111111111111111111
1111111111111111111001111111111111111111
1111111111111111111001111111111111111111
1111111111111001111111111001111111111111
1111111111100000011111100000011111111111
1111111111000000001111000000000111111111
1111111111100000011111100000011111111111
1111111111111001111001111001111111111111
1111111111111111111001111111111111111111
1111111111111111110000111111111111111111
1111111111111111110000111111111111111111
1111111111111111100000011111111111111111
1111111111111111100000011111111111111111
11111111111111111000E0011111111111111111
1111111111111111000000001111111111111111
11111111111111110000C0001111111111111111
1111111111111110000000000111111111111111
11111111111111000000P0000011111111111111
1111111111111100000000000011111111111111
1111111111111001000000001001111111111111
1111111111111011110000111101111111111111
1111111111111111111001111111111111111111
1111111111111111111111111111111111111111
1111111111111111111111111111111111111111
1111111111111111111111111111111111111111
1111111111111111111111111111111111111111
