1111111111
1100000011
1100C00E11
1111111111
