1111111111
11P0000011
1100C00011
1111111111
