1111111111
11P0002011
1100C00E11
1111111111