1111111111
11P0000011
1100C00E11
0000000000