1111111111
11P0000011
1100000011
1111111111
