1111111111
11P0000011
1100C00E1111
1111111111