1111111111
11P00P0011
1100C00E11
1111111111