11111111111111111111111111111111111
11111111111111111111111111111111111
11000111111111111111111111111111111
1100P000000000000000000000000100111
11100100100100111111111111111100111
111001001001001000000000001000C0111
11111111111100111100100111111100111
11100100000000100000100100100000111
11100111100100100100100100100100111
11100000000100100100100000100100111
11100100111111111100111100111100111
11100100000000100000100000100100111
11111111100100111100111111100100111
11100000000100000100000000000100111
11111100111100100111100111100100111
11100000100000100100100000100100111
11100111100111111100100111111100111
111C0100100100100100100000100000111
11100100100100100100111100111100111
111000001000000001000C0100000000111
11100100100111100100100111111100111
111001001001000000001000000000E0111
11111111111111111111111111111100111
11111111111111111111111111111111111
11111111111111111111111111111111111
