1111111111111111111111111111111111111
1000000000000000000000000000000000001
1000000000000000000000000110000000001
1000000000000000000000001111110000001
1000000C0E000000000000011111111100001
1000000000000000000000111111111111001
1000000000000000000001111111111111101
10000000P0000000000111111111111111101
1000000000000000001111111111111111101
1000000000000000011111111111111111101
1000110000000000111111111111111111101
10011111000V0001111111111101111111101
1011111110000011111111111001111111101
1011111111000111111111100001111111101
1001111111111111111111000001111111101
1000111111111111111110000001111111101
1000011111111111111100000001111111101
1000001111111111110000000001111111101
1000000111111111100000000001111111101
1000001111111111110000000001111111101
1000011111111111111100000001111111101
1000111111111111111110000001111111101
1001111111111111111111000001111111101
1011111111000111111111100001111111101
1011111110000011111111111001111111101
1001111100000001111111111101111111101
1000110000000000111111111111111111101
1000000000000000011111111111111111101
1000000000000000001111111111111111101
1000000000000000000111111111111111101
1000000000000000000001111111111111101
1000000000000000000000111111111111001
1000000000000000000000011111111100001
1000000000000000000000001111110000001
1000000000000000000000000110000000001
1000000000000000000000000000000000001
1111111111111111111111111111111111111
