1111111111111111111111111111111111111111111111111111
1111111111111111111001111111111111111111111111111111
1111111111111000100001111111111111111111111111111111
1111111111110000000000011111111111111111111111111111
1111111111110000000000111110111111111111111111111111
1111111111110010000000111100111111111101111111111111
1111111111110010000000111111111111111111111111111111
1111111110100111000000111111111111111000111111111111
1111111011111111100001111111111111110000011111111111
1111111100110001100001111111111111000000000000111111
1100000000101101100001111110001100000000000000000011
100000000000010010011111110000000000000C000000000001
1100000000001111110111111100000000000000000000000111
1100100000001100111111111000000000000000V00000111111
111111000V000100111111111100000000000000000011011111
1111111000000000011111110000000000000000000011111111
11111110000000001111111000000P0000000000000011111111
1111111000000001111111100110000000000000000111111111
111111110000001111111111001110000000V000011111111111
1111111110001111111111100000000000000000011111111111
1111111111011111111111000000000001000000111111111111
1111111111110111111111000000000011101100111111111111
1111111111111100111111100000000011111111111111111111
1111111111111100001111111100000111111101011111111111
1111111111111100000011111100E01111111111111101111111
1111111111111100000111111100001111111111110011111111
1111111111111110000111111110001111111111100001111111
1111111111111110001111111110011111111111000000111111
1111111111111110011111111110111111111111101000111111
1111111111111100111111111111111111111111111111111111
1111111111111100111111111111111111111111111111111111
1111111111111101111111111111111111111111111111111111
1111111111111111111111111111111111111111111111111111
